1111111111111111111111111111111111
1E100000000000000000000000000000P1
1000010100100000101001000000010001
10001001110101000100100000B0100011
100000011000000000000000000001C111
1111111111111111111111111111111111
