1111111111111111111111111111111111
1E0000000C0000000000000000000000P1
1010010100100000101001000000010001
1010010011101010001001000000010111
10000000110000000000000000000000
1111111111111111111111111111111111