1111111111111111111111111111111111
1E100000000000000000000000000000P1
1000010100100000101001000000010001
1000100111010100010010000000111111
100000011000000000000000000011C111
1111111111111111111111111111111111
