1111111111111111111111111111111111
1E100000000000000000000000000000P1
1010010100100000101001000000010001
1010010011101010001001000000010001
10C00000110000000000000000000000C1
1111111111111111111111111111111111